im WortSchatz von RainerWasserfuhr sind unter anderem folgende aller 676 TwoLetterAcronym's mit einer BeDeut'ung ConNect'ed:
* aa: AirLine
* ab: AnRuf
* ac: Aachen
* ad: Anno Domini
* ag: AhGe
* ai: ArTelligence
* ak Arbeitskreis
* am ante meridiem
* an
* ap
* au
* av
* bc: before JesusChrist
* bd: Bidet
* bh: FutureTits
* bi: Business Intelligence
* bm: Bergheim
* bp: British Petroleum
* cb
* cc
* cd
* dd: StadtDresden
* fc
* gm: GummersBach
* gv
* ki: KuenstlicheIntelligenz
* kl: KaisersLautern
* nt: MyersBriggs
* pm: post meridiem
* sh: shell
* sj: MyersBriggs, Societas JesusChrist
* sk: Sonderkomission
* so: siee oben, Solingen
* su: siehe unten, Sowjetunion, supersuer
* vi: vim
* zb
