im WortSchatz von RainerWasserfuhr sind unter anderem folgende aller 676 TwoLetterAcronym's mit einer BeDeut'ung ConNect'ed:
* aa: American AirLine's
* ab: AnRuf-Beantworter
* ac: Aachen, AlternatingCurrent
* ad: Anno Domini
* af: AirFrance
* ag: AhGe
* ai: ArtificialIntelligence
* ak: ArbeitsKreis
* am: ante meridiem
* an: an
* ap: AccessPoint, AssociatedPress
* au: Abgasuntersuchung
* av: AnalVerkehr
* ba: BritishAirways
* bc: before JesusChrist
* bd: Bidet
* bh: FutureTits
* bi: Business Intelligence
* bm: Bergheim
* bp: British Petroleum
* cb: CottBus, CitizensBand 
* cc: CarbonCopy
* cd: CompactDisk, change directory
* ct: ComputerTomography
* da: da, DarmStadt, DiplomArbeit
* db: DeutscheBahn, DeutscheBank, DataBase
* dc: DistrictOfColumbia, DirectCurrent
* dd: StadtDresden
* de: DeutschLand
* fc: FussballClub
* fl: Florida, Fl√∂te
* gm: GummersBach, GeneralMotors
* gv: GeschlechtsVerkehr
* im: im, InstantMessaging
* in: in, India
* kb: KiloByte
* kg: KiloGram
* ki: KuenstlicheIntelligenz
* kl: KaisersLautern
* kw: KalenderWoche, KiloWatt
* lh: LuftHansa
* ls: list directory
* nt: MyersBriggs
* pm: post meridiem
* sh: shell
* sj: MyersBriggs, Societas JesusChrist
* sk: SoKo
* so: siehe oben, Solingen
* su: siehe unten, SowjetUnion, superuser
* va: vor allem
* vi: vim
* xp: WindowsXp, ExtremeProgramming
* zb: zum Beispiel
